###############################################################################
#...................................@.........................................#
#.............##.....Z.........................................##.............#
#............#...........##########################..............#............#
#...........#............#..........<?>...........#....Z..........#...........#
#..........#.............#.....###.......###......#................#..........#
#.........#........H.....#....#.............#.....#.................#.........#
#........................######.......D......######...........H...............#
#.............................................................................#
###############################################################################